XXXXXXXXXXXXXXXXXXXXXXXXXXXXXXXXXXXXXXXXXXXXXXXXXXXXXXXXXXXXXXXXXXXXXXXX
X                               X                                      X
X                               X                                      X
X                               X                                      X
X                               X                                      X
X                               X                                      X
X                               X                                      X
X                               X                                      X
X                               X                                      X
X                               X                                      X
X                               X                                      X
X                               X                                      X
X                               X                                      X
X                               X                                      X
X                                                                      X
X                               X                                      X
X                               X                                      X
X                               X                                      X
X                               X                                      X
X                               X                                      X
X                               X                                      X
X                               X                                      X
X                               X                                      X
X                               X                                      X
X                               X                                      X
X                               X                                      X
X                               X                                      X
X                               X                                      X
X                               X                                      X
X                               X                                      X
X                               X                                      X
X                               X                                      X
X                               X                                      X
X                               X                                      X
X                               X                                      X
X                               X                                      X
X                               X                                      X
X                               X                                      X
X                               X                                      X
X                               X                                      X
X                               X                                      X
X                               X                                      X
X                               X                                      X
X                               X                                      X
X                               X                                      X
X                               X                                      X
X                               X                                      X
X                               X                                      X
X                               X                                      X
X                               X                                      X
X                               X                                      X
XXXXXXXXXXXXXXXXXXXXXXXXXXXXXXXXXXXXXXXXXXXXXXXXXXXXXXXXXXXXXXXXXXXXXXXX
start 25, 25
end 67, 1
